######################################
#                                    #
#                                    #
#                                    #
#   #######  #######   ###########   #
#   #######  #         #         #   #
#   #######  #         # c #     #   #
#   #######  #    ###########    #   #
#                           #    #   #
#                           #    #   # 
#   #######   #########     #    #   #
#   #         #                  #   #
#   #         #                  #   #
#   #######   #        ###########   #
#             #                      #
#             #                      #
######################################