################################
#   c                          #
#                              #
#  #######  ######  #########  #
#  #######  #       #       #  #
#  #######  #       # c #   #  #
#  #######  #   ##########  #  #
#                        #  #  #
#                        #  #  # 
#  #######   #######     #  #  #
#  #         #              #  #
#  #         #              #  #
#  #######   #      #########  #
#            #                 #
#            #                 #
################################