################################
#   c                          #
#                              #
#  #     #      ##  #########  #
#  #######  #       #       #  #
#  #######  #       # c #   #  #
#  #######  #   ##########  #  #
#                        #  #  #
#                        #  #  # 
#  #######   ###         #  #  #
#  #         #              #  #
#  #         #              #  #
#      ###   #      #########  #
#            #                 #
#            #                 #
#            #                 #
#            #                 #
#            #                 #
#            #                 #
#            #                 #
#            #                 #
################################